Linkin Park - Final Mascarade
Korn - Make Me Bad
Deftones - Back To School
Limp Bizkit - Re Arranged
Falling In Reverse - Fuck You And All Your Friends
Avenged Sevenfold - Almost Easy
Bring Me The Horizon - Avalanche
Escape The Fate - Ungrateful
Slipknot - (sic)
Rammstein - Sonne
Laibach - Tanz Mits Laibach
Die Toten Hosen - Launne Der Natur
And One - Playing Dead
Rage Against The Machine - Killing In The Name
Evanescence - Going Under
Poppy - V.A.N
Bad Omens - Dethrone
Motionless In White - Sign Of Life
Pierce The Veil - Circles
Sleeping With Sirens - Feel
Trivium - 
Bullet For My Valentine - Waking The Demon
Hawtorne Heights - Pink Hearts
Kittie - 
Mindless Self Indulgence - Straight To Video
A Day To Remember - All Signs Point To Laudertale
Adema - Freaking Out
Yungblud - God Save Me But Dont Drown Me Up
Twenty One Pilots - My Blood
Machine Gun Kelly - Title Track
Mudvayne - Determined
Static-X - Bleed For Days
Mushromhead - Qwerty
Black Veil Brides - Coffin
Spiritbox - Im With You
Paramore - Pressure
Asking Alexandria With Danny - A Canddelit With Inamorta
Asking Alexandria With Dennis - Send Me Home
Avril Lavigne -Sk8ter Boi
Three Days Grace - One X
My Chemical Romance - The World Is Ugly
6arelyhuman - Faster N Harder
Architects - An Ordinary Extinction
Killswitch Engage - My Curse
Breaking Benjamin - The Diary Of Jane
Thirty Seconds To Mars - Beautiful Lie
Attack Attack - Stick Stickly
The Cure - Lullaby
Oasis - D`You Know What I Mean
The Beatles - Hey Jude
Queen - Bicycle Race
Queen Of Stone Age - No One Knows
Alesana - The Last Three Letters
Rob Zombie - Ironhead
Ghost - Kiss The Goat
System Of A Down - Sugar
The 1975 - The Song
Disturbed - The Land Of Confusion
Ice Nine Kills - Closer
Slaugther To Prevail - Rusian Grizzly
Babymetal - Song 4
While She Sleeps - Silence Speaks
All Time Low - Something Gotta Give
Jonathan Davis - Underneath My Skin
Andy Black - Ribcage
Eminem - Lose Yourself
I Prevail - Gasoline
Incubus - Love Hurts
Kim Dracula - Make Me Famous
LMFAO - Lets Get Ridiculous
Nirvana - In Bloom
Story Of The Year - Until The Day I Die
AFI - The Boy Who Destroyed The World
Drowning Pool - Bodies
Fall Out Boy - 
Good Charlotte - The Anthem
Green Day - 21 Guns
Heavysaurios - Quiero Leche
Hoobstank - The Reasson
Jimmy Eat The World - The Middle
Lorna Shore - To The Hellfire
Metallica - Symphony Of Destruction
New Found Glory - My Friends Over You
Nickelback - Saturday Nights Alright For Figthing
Pantera - Walk
Panic At The Disco - I Write Sins Not Sirens
Papa Roach - Scars
Puddle Of Mudd - 
Rise Against - Sattelite
Simple Plan - Perfect
Skrilex - Reptile Theme
SoundGarden - Burden In My Head
Starset - My Demons
Faith No More - 
Tan Bionica - Ciudad Magica
The All American Rejects - 
The Calling - 
The Rasmus - 
The Red Jumpsuit Apparatus -
Carajo - 
Yellowcard - Ocean Avenue
Silverstein -
Powerman5000 -
